# 床タイルセット 16x16。base_a/b が基本、moss/crack/stain がアクセント、panel は金属板
# 右端・下端 1px の目地(S)でタイルの継ぎ目を作る
# 変換: dotnet run --project tools/dotee/Dotee -- render --input games/MessBreak/art/tiles/floor.sprite.txt
palette:
B = #3A3F4B   # 石床ベース
L = #454B58   # 明スペック
D = #313640   # 暗スペック
S = #262A33   # 目地
M = #46523F   # 苔
N = #2E3540   # 染み
C = #23272F   # ひび
P = #4E5563   # 金属板
R = #5A6274   # 板の縁(明)
V = #2C313B   # 板の縁(暗)・リベット
frame: base_a
BBBBBBBBBBBBBBBS
BBBBLBBBBBBBBBBS
BBBBBBBBBBDBBBBS
BBBBBBBBBBBBBBBS
BBLBBBBBBBBBBBBS
BBBBBBBBLBBBBBBS
BBBBBBBBBBBBBLBS
BBBBBDBBBBBBBBBS
BBBBBBBBBBBBBBBS
BLBBBBBBBBDBBBBS
BBBBBBBBBBBBBBBS
BBBBBBLBBBBBBBBS
BBBDBBBBBBBBBBBS
BBBBBBBBBBLBBBBS
BBBBBBBBBBBBBBBS
SSSSSSSSSSSSSSSS
frame: base_b
BBBBBBBBBBBBBBBS
BBBBBBBBBDBBBBBS
BLBBBBBBBBBBBBBS
BBBBBBBBBBBBLBBS
BBBBBBDBBBBBBBBS
BBBBBBBBBBBBBBBS
BBBLBBBBBBLBBBBS
BBBBBBBBBBBBBBBS
BBBBBBBBDBBBBBBS
BBBBBBBBBBBBBBBS
BBBBLBBBBBBBDBBS
BBBBBBBBBBBBBBBS
BBBBBBBBBLBBBBBS
BDBBBBBBBBBBBBBS
BBBBBBBBBBBBLBBS
SSSSSSSSSSSSSSSS
frame: moss
BBBBBBBBBBBBBBBS
BBMMBBBBBBBBBBBS
BMMBBBBBBBDBBBBS
BBBBBBBBBBBBBBBS
BBBBBBBBBBBBMBBS
BBLBBBBBBBBMMBBS
BBBBBBBBBBBBBBBS
BBBBBBBBBBBBBBBS
BBBBBMBBBBBBBBBS
BBBBMMMBBBBBBBBS
BBBBBMBBBBBBBBBS
BBBBBBBBBBBBBBBS
BBBBBBBBBBBLBBBS
BDBBBBBBBBBBBBBS
BBBBBBBBBBBBBBBS
SSSSSSSSSSSSSSSS
frame: crack
BBBBBBBBBBBBBBBS
BBBBBBBBBBCBBBBS
BBBBBBBBBCBBBBBS
BBBBBBBBCBBBBBBS
BBBBBBBCBBBBBBBS
BBBBBBCBBBBBBBBS
BBBBBBCBBBBBBBBS
BBBBBCBBBBBBBBBS
BBBBCBBBBBBBBBBS
BBBBCBBBCCBBBBBS
BBBCBBCCBBBBBBBS
BBBCCCBBBBBBBBBS
BBBBCBBBBBBBBBBS
BBBBBCBBBBBBBBBS
BBBBBBBBBBBBBBBS
SSSSSSSSSSSSSSSS
frame: stain
BBBBBBBBBBBBBBBS
BBBBBBBBBBBBBBBS
BBBBBNNBBBBBBBBS
BBBBNNNNBBBBBBBS
BBBNNNNNNBBBBBBS
BBBNNNNNNNBBBBBS
BBBBNNNNNNBBBBBS
BBBBBNNNNBBBBBBS
BBBBBBNNBBBBBBBS
BBBBBBBBBBBBBBBS
BBBBBBBBBBBBBBBS
BBBBBBBBBBLBBBBS
BBBBBBBBBBBBBBBS
BBDBBBBBBBBBBBBS
BBBBBBBBBBBBBBBS
SSSSSSSSSSSSSSSS
frame: panel
RRRRRRRRRRRRRRVS
RPPPPPPPPPPPPPVS
RPVPPPPPPPPPVPVS
RPPPPPPPPPPPPPVS
RPPPPPPPPPPPPPVS
RPPPPPPPPPPPPPVS
RPPPPPPPPPPPPPVS
RPPPPPPPPPPPPPVS
RPPPPPPPPPPPPPVS
RPPPPPPPPPPPPPVS
RPPPPPPPPPPPPPVS
RPPPPPPPPPPPPPVS
RPVPPPPPPPPPVPVS
RPPPPPPPPPPPPPVS
VVVVVVVVVVVVVVVS
SSSSSSSSSSSSSSSS
